000000000000000
000000000000000
000000000000000
000011111110000
000012544410000
000012222211000
000111322221000
000122222221000
000123213121000
000122212221000
000111111111000
000000000000000
000000000000000
000000000000000
000000000000000