000000000000000
000000000000000
000000000000000
000001111000000
000011221000000
000015321000000
000011321100000
000011232100000
000014322100000
000014424100000
000011111100000
000000000000000
000000000000000
000000000000000
000000000000000
