000000000000000
000000000000000
000000000000000
000001111100000
000011222110000
000012234411000
000113214341000
000122214441000
000123111321000
000122323211000
000115222210000
000011111110000
000000000000000
000000000000000
000000000000000